####################
# #        #       #
# # ######## #######
# # #        #     #
# # # ######       #
#     #      #     #
####################